AAAAA#AAAAAAAAAA
AAAAA#AAAAAAAAAA
AAAAAAAAAADDDAAA
AAAAA#AAAADDDAAA
AAAAA#AAAADDDAAA
AAAAA#AAAADDDAAA
#############A##
AAAAAAACCCCAAAAA
AAAAAAACCCCAAAAA
AAAAAAABBBBAAAAA
AAAAAAABBBBAAAAA
AAAAAAAAAAAAAAAA
AAAAAAAAAAAAAAAA
AAAAAAAAAAAAAAAA
AAAAAAAAAAAAAAAA
AAAAAAAAAAAAAAAA
